ID	Sequence	Target.bp	Target.base
Marker1	GGATTTTATTACCTGATGAAAGAACCGTGGCGGTGACAGTATTATAGTGAD	51	[T/C]
Marker2	AGTCGACTGAGATTTCACCAAATGTCACTCAAGTGACATAACATGCAAAAD	51	[T/G]
Marker3	TCAAACAAGAGATTGATAGTATATCTCTATGACAAAGTAAAATGTGGTCAD	51	[T/C]
Marker4	AAAATCCTTAGGCTCCAATCTAGTGATGGGTCCTTCCTCTATTCTCCTTCD	51	[T/G]
Marker5	TTCACATTCAACCTCAGTCCGTTCAAGAACCTGAATATCGTTTCTGACAAD	51	[T/C]
Marker6	TTAGCAGGTGAGACAAGAATAAATTATCCCTCCAAGTCTCTAGGTCCTTTD	51	[T/C]
Marker7	GATGATGATGATAAAGCAAAGAAGGCAAAAGGGTGGCAGCTAAGGAATGAD	51	[A/G]
Marker8	TGATGGTTTTAGTTGTCAAGAAGGGATCTTTTTAGATGTATGTTGTTACTD	51	[A/G]
Marker9	TTTGCATCTTTTTTGCCAAACGTTATTTATTTAATTTAATTTATTTTCGCD	51	[T/G]
Marker10	CTTGTTCCGCCAACTTTTTAGAAATCAAGCAAAGCACAAAATGTTTCAGGD	51	[A/C]
Marker11	TTCTTTGCAATATCATCATCATCATCATTTACATCATCCTTAACACTCGGD	51	[T/C]
Marker12	ACACAAATGATGAAATGTATCCATTACAAGACATCGCATCCATTTTGAATD	51	[T/C]
Marker13	ATTATAGCACACGTAATTAGCAGGTGAATTATGAACAAATGATCAGTTAAD	51	[T/C]
Marker14	TCAAGGCAACGATACTTATAGCACTGGATACGCTGGTGGCCTGCGCAATCD	51	[T/G]
Marker15	TGTGGTGAATTATGTCACAAATAGAGGACGCAAGTTGAATAAACCAGGCAD	51	[T/C]
Marker16	AACTAATTATTTGATTAATTCACAGCTGTATTTGAGAAGTTTGAGAAGGAD	51	[T/C]
Marker17	CGCAGGCCACCAGCGTTCACAGTGCTTCAGGTATCGTTGCCTTGACTTGGD	51	[T/G]
Marker18	CCCGCAGAGCGTGGCCGGCACACGAAGAATCGCTCAACACACATGGTGCAD	51	[T/C]
Marker19	TTTCATTACCCGACAAATCGCTATGAAGGTATTTATCAATAATGTCAGCCD	51	[A/C]
Marker20	TAACAAATATATTTTCAATAAGCAGTTTTTAAATGATTCAGTGAGTGTCAD	51	[A/C]
Marker21	AATCATATTCAAGAACAATGTTTTCAATATGTTCACAACTTAAAAAATATD	51	[A/G]
Marker22	TCTTTGTTTTTTCATTGTATTTTTCATTGGTTCCAATTGTTTCTTTCTTGD	51	[A/G]
